NO ./assets/sidetext1.xpm  
SO ./assets/sidetext1.xpm  
WE ./assets/sidetext2.xpm 
EA ./assets/sidetext3.xpm

F 220,250,230  
C 0,0,0    

1111111111111111111111111111111111111
1000000000000000000000000000000000001
1000000000000000000000000000000000000111111111
100000000000000000000000000000000000001     11
1000000000000000000000000000000000000111111111
1001000000000000000000000000000001001        1
1000000000000000000000000000000000000111111111
1000000000000000000000000000000000000000000001
1000000000000000000000000000000000000111111111
1001000000000000000000011100100001001
1101000111000000000000010000100001001
 100100000000000000000001001110000101
11111111111111111111111111111111111111
                 1000000000000000000011111111111111111
11111111111111111111111111111111111111
101000000000000000000010000100001011
1001000000111000000000011100100001001111111
1001100000000000000000010000100001001
1001000000000011100000010011100011001
1001100000000000000000010000100001001
1001111100000000000000011100100001001
1001   100000000000000010000100001001
1001   100000000000000010011100001001
1001111100000000000000010000000001001
1001000000000000000000011111111111001
1000000000000000011110000000000000001
1001000000000000011110000000000001001
1000000000000000011110000000000000001
1001000000000000011110000000000001001
1001000000000000000000000000000001001
1001000000000000000000000000000001001
1001000000000000000000000000000001001
1001000000000000000000000000000001001
1001000000000000000000000000000001001
1001000000000000000000000000000001001
1001000000000000000000000000000001001
1001000000000000000000000000000001001
1001000000000000000000000000000001001
1001000000000000000000000000000001001
1001000000000000000000000000000001001
1001000000000000000000000000000001001
1001000111100000000000001111010001001
1001000111100000000000001000010001001
1001000111100000000000001000010001001
1001000000000000000000001011110001001
1E01000000000000000000000000000000001
1111111111111111111111111111111111111
